{
  "lines": [
	"00900066001190001100110900",
	"00000066001100001100110000",
	"00000000000000001100220000",
	"00000000000000001100220000",
	"00000066000022001100110000",
	"00000066001122001100110000",
	"22001166002200001100110000",
	"00001166002200110000110000",
	"00001166000000110000000000",
	"00001166000000110000000000",
	"11001166660066666666000011",
	"11001166660066666666000011",
	"00000000000000550066002222",
	"00000011000000550066000000",
	"11110111002255555566000000",
	"11110111002255555566001111",
	"11000100001155555566001100",
	"00000100001155555566001100",
	"00000000001100550066005500",
	"00220000001100550066005500",
	"00110000001111110000555555",
	"00110022000000000000555555",
	"00110011000000000066555555",
	"00110011000111100066555555",
	"00000000000140100066005500",
	"00000000070100108066005500"
  ],
  "tanks": {
	"basic": 2,
	"strike": 8,
	"medium": 2,
	"heavy": 8
  }
}