{
  "lines": [
	"33933333333390333333333933",
	"33333333333300333333333333",
	"33333333333333333333333333",
	"33333333333333333333333333",
	"33333311333333333311333333",
	"33333311333333333311333333",
	"33110011001133110011001133",
	"33110011001133110011001133",
	"33111111000000000011111133",
	"33000011000000000011000033",
	"33333311001122110011333333",
	"33333311111122111111333333",
	"22333333002200220033333322",
	"22333333000000000033333322",
	"33333333000000000033333333",
	"33333333001100110033333333",
	"33333333001100110033333333",
	"33333333001100110033333333",
	"33333311000000000011333333",
	"33333311000011000011333333",
	"33113311002222220011331133",
	"33113311000000000011331133",
	"00110011000000000011001100",
	"00111111000111100011111100",
	"00110000000140100000001100",
	"00000000070100108000000000"
  ],
  "tanks": {
	"basic": 6,
	"strike": 4,
	"medium": 2,
	"heavy": 8
  }
}