{
  "lines": [
	"00900066000090006600000900",
	"00000066000000006600000000",
	"66660066006666666600666666",
	"66660066006666666600666666",
	"55551100001100006600665566",
	"55551100001100006600665566",
	"55666666660022000011555555",
	"55666666660022000011555555",
	"55550066000066006666666655",
	"55550066000066006666666655",
	"66660066006666000066000000",
	"66660066006666000066000000",
	"00001155110011550066000066",
	"00001155110011550066000066",
	"00666655666666660055110066",
	"00666655666666660055110066",
	"11000011000066005555660066",
	"11000011000066005555660066",
	"66660066660066116666660000",
	"66660066660066116666660000",
	"00001100555500005566000066",
	"00001100555500005566000066",
	"00666666550000000066006666",
	"00666666550111100066006666",
	"00660000000140100000000000",
	"00660000070100108000000000"
  ],
  "tanks": {
	"basic": 0,
	"strike": 8,
	"medium": 6,
	"heavy": 6
  }
}