{
  "lines": [
	"00900000000090000000110900",
	"00000000000000000000110000",
	"00116666002200110000000000",
	"00116666002200110000000000",
	"00006666115555556666002200",
	"00006666115555556666002200",
	"00000000005555556666110000",
	"00000000005555556666110000",
	"00220000666600550000000000",
	"00220000666600550000000000",
	"55551100666622000000001100",
	"55551100666622000000001100",
	"55555500000000000022000022",
	"55555500000000000022000022",
	"00116666001100000000000000",
	"00116666001100000000000000",
	"22006666555566665555001100",
	"22006666555566665555001100",
	"00000000550066665555666600",
	"00000000550066665555666600",
	"00000022550000005555666600",
	"00000022550000005555666600",
	"00001100110000000000000000",
	"00001100110111100000000000",
	"11000000000140100011220000",
	"11000000070100108011220000"
  ],
  "tanks": {
	"basic": 0,
	"strike": 4,
	"medium": 10,
	"heavy": 6
  }
}