{
  "lines": [
	"09000000111109000000000090",
	"00000000111100000000000000",
	"00000000110000002222220000",
	"22001100110000000000220000",
	"22001100000011000000000000",
	"22001100000011000000000000",
	"11001111110011110066660066",
	"11001111110011110066660066",
	"11000000110000000066000000",
	"00000000000000000066000000",
	"00000000666600666666001111",
	"00001100666600666666001111",
	"11110000661100111000000000",
	"11110000661100111000000000",
	"00000000660000000000022000",
	"00000000660000000000022000",
	"66666600660000000000020000",
	"66666600660000000000020000",
	"00000000000000000000021111",
	"00000011110000000000021111",
	"00000000111111111100000000",
	"00000000110000001111000000",
	"11111100000000000011110000",
	"11110000000111100000110000",
	"11000000000140100000000000",
	"00000000070100108000000000"
  ],
  "tanks": {
	"basic": 8,
	"strike": 5,
	"medium": 5,
	"heavy": 2
  }
}