{
  "lines": [
	"00900000100109000000000900",
	"00000000100100000000000000",
	"10101001001000001010000000",
	"10101001001000001010000000",
	"10101011110000001011100000",
	"10101011110000001011100000",
	"01010011100000011011110000",
	"01010011100000011011110000",
	"00100011011000101111110000",
	"00100011011000101111110000",
	"00100100001110110101110000",
	"00100100001110110101110000",
	"00100000011111100010110000",
	"00100000011111100010110000",
	"00010000101111100010110000",
	"00010000101111100010110000",
	"00011111001111110010101111",
	"00010000001111110010100011",
	"00010000011011011010100101",
	"00010000011011011010100101",
	"00001000110110111100000100",
	"00001000110110111100000100",
	"00001001100000001110001000",
	"00001001100111101110001000",
	"00001001000140100011110000",
	"00001001070100108011110000"
  ],
  "tanks": {
	"basic": 0,
	"strike": 10,
	"medium": 4,
	"heavy": 6
  }
}