{
  "lines": [
	"00900000000090000000000900",
	"00000000110000000000110000",
	"00110011110000333333111100",
	"00110011110000333333111100",
	"00110000110022333333333300",
	"00110000110022333333333300",
	"33333320110000113333333300",
	"33333320110000113333333300",
	"33333333333311110110000000",
	"33333333333311110110000000",
	"00000233333333110110002222",
	"00000233333333110110000000",
	"11111111333333333333331111",
	"11111111333333333333331111",
	"00000011113333333320000000",
	"00000011113333333320000000",
	"00111111003333331111001100",
	"00111111003333331111001100",
	"33333311330000000011001100",
	"33333311330000000011001100",
	"33333333332200220000001100",
	"33333333330000000000111100",
	"11333333330000000011000000",
	"11333333330111100011000000",
	"11112000000140100011001100",
	"11112000070100108011001100"
  ],
  "tanks": {
	"basic": 8,
	"strike": 2,
	"medium": 8,
	"heavy": 2
  }
}