{
  "lines": [
	"00900000000090111111000900",
	"00000000000000111111000000",
	"00111111000000000011000000",
	"00111111110011000011000000",
	"00000000110011000000001111",
	"00000000110000000000001111",
	"00666666666600111000001122",
	"00666666666600111000001100",
	"00000000006600110022201100",
	"00002222226600110022201100",
	"11001111116666660066111100",
	"11001111116666660066111100",
	"00000000226600000066220000",
	"00000000226600000066000000",
	"66666600666611110066000000",
	"66666600666611110066000000",
	"00000000001122220066666600",
	"00000000001100000066666600",
	"11111100000000000000000000",
	"11111100000000000000000000",
	"00001100222200000011110001",
	"00001100000000000011110001",
	"11000000000000000011000011",
	"11000000000111100011000011",
	"00000000000140100000000000",
	"00000000070100108000000000"
  ],
  "tanks": {
	"basic": 0,
	"strike": 6,
	"medium": 8,
	"heavy": 6
  }
}