{
  "lines": [
	"00906666000090000000000900",
	"00006666000000000000000000",
	"00000066550010000000000000",
	"22000066550010000000000000",
	"55000000000020001000666600",
	"55220000000020001000666600",
	"55550022000100002055660000",
	"55550000110100002055660000",
	"55555500002200010000000000",
	"55555500002211010000000022",
	"55552200000100220000000055",
	"55550022000100221100002255",
	"55220000112200010022005555",
	"55000000002200010000005555",
	"00000000001011220000555555",
	"00000000001000220000555555",
	"00006655020000101100225555",
	"00006655020000100022005555",
	"00666600010002000000000055",
	"00666600010002000000000055",
	"00000000000001005566000022",
	"00000000000001005566000000",
	"22000000000000000066660000",
	"22000000000111100066660000",
	"22220000000140100000000022",
	"22220000070100108000000022"
  ],
  "tanks": {
	"basic": 4,
	"strike": 6,
	"medium": 4,
	"heavy": 6
  }
}