{
  "lines": [
	"00900000220090000022000900",
	"00000000220000000022000000",
	"00220000002200002255550000",
	"00220000002200002255550000",
	"00002200000000225500200000",
	"00002200000000225522200000",
	"00000022005555555555000200",
	"00000022005555555555000200",
	"00200000225555225500002200",
	"00200000225555225500002200",
	"00222055002255552200000200",
	"00002055002255552200000200",
	"00005555555555000022000000",
	"00005555555555000022000000",
	"00002055002255000000220000",
	"00222055002255000000220000",
	"00555555220022000000002200",
	"00555555220022002200002200",
	"55555522000000000200000000",
	"55555522000000000200000000",
	"00002200000000000000000222",
	"00002200000000000000000222",
	"00000000000000000000200000",
	"00000000000111100022200000",
	"20000000000140100000000000",
	"20002200070100108000000000"
  ],
  "tanks": {
	"basic": 0,
	"strike": 8,
	"medium": 4,
	"heavy": 8
  }
}