{
	"lines": [
		"00900000000009000000000900",
		"00000000000000000000000000",
		"00011111000000000000111110",
		"00010011000000000000110010",
		"01110000110055550011000001",
		"01000000110055550011000001",
		"11000000115555555511000001",
		"11000000115555555511000001",
		"11000001115522225511100011",
		"11000001115522225511100011",
		"01000011666666666666111111",
		"01111111666666666666111111",
		"00111111222211222211111110",
		"00111111222211222211111110",
		"00001111220011002211111000",
		"00001111220011002211111000",
		"00001111111111111111111000",
		"00001111111111111111111000",
		"11551111112222111111115511",
		"11550000002222000000005511",
		"11555555555555555555555511",
		"11555555555555555555555511",
		"00555555550000005555555500",
		"00555555550111105555555500",
		"00001000000140100000010000",
		"00001000070100108000010000"
	],
  "tanks": {
	"basic": 12,
	"strike": 2,
	"medium": 4,
	"heavy": 2
  }
}