{
  "lines": [
	"00900000000090000000000900",
	"00000000000000000000000000",
	"00000000110011000000000000",
	"00000000110011000000000000",
	"55000055115511550000550000",
	"55000055115511550000550000",
	"11555511111111115555115500",
	"11555511111111115555115500",
	"11111111221122111111115500",
	"11111111221122111111115500",
	"66666611111111116666665500",
	"66666611111111116666665500",
	"66111111111111111111666655",
	"66111111111111111111666655",
	"11111166111111661111115555",
	"11111166111111661111115555",
	"11116666661166666611116666",
	"11116666661166666611116666",
	"55666655555555556666556655",
	"55666655555555556666556655",
	"00555500000000005555005500",
	"00555500000000005555005500",
	"00000000000000000000000000",
	"00000000000111100000000000",
	"00000000000140100000000000",
	"00000000070100108000000000"
  ],
  "tanks": {
	"basic": 0,
	"strike": 6,
	"medium": 4,
	"heavy": 10
  }
}