{
  "lines": [
	"00900000000090000000022090",
	"00000000000000000000022000",
	"00000000000000000000220000",
	"00000000000022000000220000",
	"00000000000055000011100000",
	"00000000001155110011100000",
	"00000000005555550011100000",
	"00000000225555552211100000",
	"00000000555533555511100000",
	"00000011555533555511100000",
	"00000055553333335555100000",
	"00002255553333335555100000",
	"00005555333333333355550000",
	"00115555333333333355551100",
	"00555533333333333333555500",
	"22555533333333333333555522",
	"55553333333333333333335555",
	"55553333333333333333335555",
	"00553333333333333333335500",
	"00553333333333333333335500",
	"00553333333333333333335500",
	"00553333333333333333335500",
	"00553333330000003333335500",
	"00553333330111103333335500",
	"00553333000140100033335500",
	"00553333070100108033335500"
  ],
  "tanks": {
	"basic": 15,
	"strike": 2,
	"medium": 2,
	"heavy": 1
  }
}