{
  "lines": [
	"00900000000090000000000900",
	"00000000000000000000000000",
	"00002255220000000000000000",
	"00002255220000000000000000",
	"00000055005500000000000000",
	"00000055005522000000000000",
	"00550000000055000000000000",
	"00550000000055110000000000",
	"00555500005500550000000000",
	"00555500005500552200000000",
	"00550055005500005500000000",
	"00550055005500005511000000",
	"00550000550000005555000000",
	"00550000550000005555220000",
	"00005500000000555555550000",
	"00005500000000555555551100",
	"00000055000055005555555500",
	"00000055000055005555555500",
	"11000000000055000055555522",
	"11000000000055000055555522",
	"11110000000000550055555555",
	"11110000000000550055555555",
	"22111100000000005500555555",
	"22111100000111105500555555",
	"22221111000140105500005555",
	"22221111070100108000005555"
  ],
  "tanks": {
	"basic": 16,
	"strike": 2,
	"medium": 0,
	"heavy": 2
  }
}