{
	"lines": [
		"00901100001109000011000900",
		"00001100001100110011000000",
		"55111111001100000011100000",
		"55111111001100220011100000",
		"55555500001100110011000110",
		"55555500000000110000000110",
		"55666666666666666666660066",
		"55666666666666666666660066",
		"00110000000000000000000000",
		"00110000000011110000000000",
		"00001100000111111111112222",
		"00001100000111110011000000",
		"11110011000111115511000011",
		"11110011000111115511222211",
		"00000022000000555555550000",
		"00000022002200555555550000",
		"66660066666666660066666666",
		"66660066666666660066666666",
		"55550001000000000000000000",
		"55550001000011110000000000",
		"55551100100000010000001100",
		"55551100100000010022111100",
		"55001100100000000011001100",
		"55221100100111100000001100",
		"00000000000140100000001100",
		"00000000070100108011000000"
	],
  "tanks": {
	"basic": 7,
	"strike": 4,
	"medium": 7,
	"heavy": 2
  }
}