{
  "lines": [
	"00900000000090000000000900",
	"00000000000000000000000000",
	"00000000002222000000000000",
	"00000000002222000000000000",
	"00000000000022000000000000",
	"00000000000022000000000000",
	"00222255551122115555222200",
	"00222255551122115555222200",
	"00000022555522555522000000",
	"00000022555522555522000000",
	"55000000225555552200000055",
	"55000000225555552200000055",
	"22550000005555550000005522",
	"22550000005555550000005522",
	"55000000002255220000000055",
	"55000000220055002200000055",
	"00000000220000002200000000",
	"00000000220022002200000000",
	"00000022000022000022000000",
	"00000022000022000022000000",
	"00000000000000000000000000",
	"00000000000000000000000000",
	"00000000000000000000000000",
	"00000000000111100000000000",
	"00002200000140100000220000",
	"00002200070100108000220000"
  ],
  "tanks": {
	"basic": 0,
	"strike": 10,
	"medium": 4,
	"heavy": 6
  }
}