{
  "lines": [
	"00902200112209000000010900",
	"00002200110000000000010000",
	"00001100115500111111110000",
	"00001100115500001111110000",
	"00555500115501100000002222",
	"00555500115501100000002222",
	"55555555555511111100011100",
	"55555555555511111100011100",
	"00005555000022110001111101",
	"00005555111100110001110001",
	"11220000111100000011110001",
	"11000011000000000011000001",
	"01000011333333333333333333",
	"01001111333333333333333333",
	"01001100333333333333333333",
	"01000000333333333333333333",
	"00002200333333333333333333",
	"00002200333333333333333333",
	"11001100333333333333333333",
	"11001100333333333333333333",
	"01001100333333333333333333",
	"01001100333333333333333333",
	"01001100000000003333333333",
	"01001100000111103333333333",
	"00001100000140100033333333",
	"00000000070100108033333333"
  ],
  "tanks": {
	"basic": 10,
	"strike": 4,
	"medium": 4,
	"heavy": 2
  }
}