{
  "lines": [
	"00900000000090000000000900",
	"00000000000000000000000000",
	"00000000000000000000000000",
	"00000000001111000000220000",
	"00000000005555000000550000",
	"00222200115555220011551100",
	"00555500555555550055555500",
	"11555511555555551155555511",
	"55555555555555555555555555",
	"55555555555555555555555555",
	"22556655555555556655555555",
	"22556655555555556655555555",
	"55556666665555556666665522",
	"55556666665555556666665522",
	"55555555665522555555665555",
	"55555555665522555555665555",
	"55555555555555555555555555",
	"55555555555555555555555555",
	"55555555551111555555555522",
	"55555555550000555555555500",
	"22555555110000115555552200",
	"00555555000000005555550000",
	"00221111000000001111110000",
	"00000000000111100000000000",
	"00000000000140100000000000",
	"00000000070100108000000000"
  ],
  "tanks": {
	"basic": 4,
	"strike": 8,
	"medium": 4,
	"heavy": 4
  }
}